//width, depth
15, 15,,,,,,,,
//chip id
1, 1, 1, 1, 1, 1, 1, 1, 1, 1, 1, 2, 1, 1, 1
1, 1, 1, 1, 1, 1, 1, 1, 1, 1, 2, 2, 1, 0, 0
1, 1, 1, 1, 1, 1, 1, 1, 1, 1, 2, 2, 1, 1, 0
1, 1, 1, 1, 1, 1, 1, 1, 1, 1, 2, 2, 1, 1, 1
1, 1, 1, 1, 1, 1, 1, 1, 1, 1, 2, 1, 1, 1, 1
1, 1, 1, 1, 1, 1, 1, 1, 1, 1, 2, 1, 1, 1, 1
1, 1, 1, 1, 1, 1, 1, 1, 1, 1, 2, 1, 1, 1, 1
2, 2, 1, 1, 1, 1, 1, 1, 1, 1, 2, 1, 1, 1, 1
2, 2, 2, 1, 1, 1, 1, 1, 1, 1, 2, 1, 1, 1, 1
1, 1, 2, 2, 1, 1, 1, 1, 1, 1, 2, 2, 1, 1, 1
1, 1, 1, 2, 2, 1, 1, 1, 1, 1, 2, 2, 2, 2, 2
1, 1, 1, 0, 2, 2, 1, 1, 1, 1, 2, 2, 2, 2, 2
1, 1, 1, 0, 1, 2, 2, 2, 1, 1, 2, 2, 1, 1, 1
1, 1, 1, 0, 1, 1, 2, 2, 2, 2, 2, 2, 1, 1, 1
1, 1, 1, 0, 0, 1, 1, 2, 2, 2, 2, 2, 1, 1, 1
//height
6, 5, 4, 3, 4, 5, 6, 6, 9, 5, 5, 2, 4, 4, 5
5, 5, 4, 3, 3, 3, 4, 6, 9, 5, 2, 2, 4, 4, 4
4, 4, 4, 4, 3, 3, 4, 6, 9, 5, 2, 2, 3, 4, 4
4, 4, 4, 3, 3, 3, 4, 6, 9, 5, 2, 2, 3, 3, 3
5, 5, 4, 3, 3, 4, 5, 7, 9, 5, 2, 3, 3, 3, 3
6, 5, 4, 3, 3, 3, 3, 5, 8, 5, 2, 3, 4, 5, 5
4, 4, 3, 3, 3, 3, 3, 5, 8, 5, 2, 3, 5, 6, 7
2, 2, 3, 3, 3, 4, 6, 7, 9, 5, 2, 3, 4, 6, 6
2, 2, 2, 3, 3, 3, 3, 6, 9, 5, 2, 3, 4, 4, 5
3, 3, 2, 2, 3, 3, 3, 5, 9, 5, 2, 2, 3, 3, 3
3, 3, 3, 2, 1, 3, 4, 6, 8, 5, 1, 1, 1, 0, 0
3, 3, 3, 3, 1, 1, 3, 5, 8, 5, 1, 1, 1, 0, 0
4, 4, 3, 3, 3, 1, 1, 1, 6, 6, 1, 1, 3, 3, 3
5, 4, 4, 3, 3, 3, 1, 1, 1, 1, 1, 0, 3, 4, 4
5, 5, 4, 3, 3, 3, 3, 0, 0, 0, 0, 0, 3, 4, 5




