//width, depth
5, 5,,,,,,,,
//chip id
1, 1, 1, 1, 2
1, 1, 1, 1, 2
1, 1, 1, 1, 2
1, 1, 0, 0, 1
2, 2, 1, 1, 0
//height
1, 1, 1, 1, 1
2, 0, 0, 0, 0
2, 0, 0, 0, 0
2, 0, 0, 0, 0
2, 0, 0, 0, 0




