//id, hp, mp, str, def, agi, mobility
0, 5, 3, 5, 3, 3, 4
1, 4, 4, 4, 4, 4, 4
2, 3, 5, 3, 4, 3, 4
3, 3, 3, 3, 3, 4, 5
4, 3, 3, 3, 3, 2, 5