//width, depth
15, 15,,,,,,,,,,,,,,,,
//chip id
2, 2, 1, 1, 1, 1, 1, 1, 1, 1, 1, 1, 1, 1, 1
1, 2, 2, 1, 1, 1, 1, 1, 1, 1, 1, 1, 1, 1, 1
1, 1, 2, 1, 1, 1, 1, 1, 1, 1, 1, 1, 1, 1, 1
1, 1, 2, 2, 1, 1, 1, 1, 1, 1, 1, 1, 1, 1, 1
1, 1, 1, 2, 2, 2, 2, 2, 2, 2, 2, 2, 2, 2, 2
1, 1, 1, 1, 2, 2, 2, 2, 2, 2, 2, 2, 2, 2, 2
1, 1, 1, 1, 1, 2, 2, 2, 0, 1, 1, 1, 1, 1, 1
1, 1, 1, 1, 1, 1, 2, 2, 0, 1, 1, 1, 1, 1, 1
1, 1, 1, 1, 1, 1, 2, 2, 1, 1, 1, 1, 1, 1, 1
1, 1, 1, 1, 1, 1, 2, 2, 1, 1, 1, 1, 1, 1, 1
1, 1, 1, 1, 1, 1, 1, 2, 2, 1, 1, 1, 1, 1, 1
1, 1, 1, 1, 1, 1, 1, 1, 2, 2, 2, 1, 1, 1, 1
1, 1, 1, 1, 1, 1, 1, 1, 1, 2, 2, 2, 1, 1, 1
1, 1, 1, 1, 1, 1, 1, 1, 1, 1, 2, 2, 2, 2, 2
1, 1, 1, 1, 1, 1, 1, 1, 1, 1, 1, 2, 2, 2, 2
//height                     
8, 7, 7, 7, 7, 6, 6, 5, 5, 5, 5, 5, 4, 4, 4
7, 7, 7, 6, 6, 6, 5, 5, 4, 4, 4, 4, 4, 3, 3
7, 7, 6, 6, 6, 5, 5, 4, 4, 3, 3, 3, 3, 3, 2
7, 7, 6, 5, 5, 5, 4, 4, 4, 3, 3, 3, 2, 2, 2
7, 6, 5, 5, 5, 4, 4, 3, 3, 2, 1, 1, 1, 0, 0
6, 6, 5, 4, 4, 4, 3, 3, 2, 2, 1, 1, 1, 0, 0
6, 6, 5, 4, 4, 3, 3, 3, 5, 4, 4, 4, 3, 2, 2
5, 5, 5, 4, 4, 3, 3, 3, 5, 4, 4, 4, 3, 3, 3
4, 4, 3, 3, 3, 3, 3, 3, 5, 5, 4, 4, 3, 3, 3
3, 3, 3, 3, 3, 3, 3, 2, 2, 2, 3, 3, 3, 3, 3
3, 3, 3, 3, 3, 3, 3, 2, 2, 2, 2, 2, 2, 1, 1
3, 3, 3, 2, 2, 2, 2, 2, 2, 1, 1, 1, 1, 1, 0
3, 3, 3, 2, 2, 1, 1, 1, 1, 1, 1, 1, 1, 0, 0
4, 4, 3, 2, 2, 1, 1, 1, 0, 0, 0, 0, 0, 0, 0
5, 4, 3, 2, 2, 1, 1, 0, 0, 0, 0, 0, 0, 0, 0
                             
